red: 0,A
green: B 
++++++++++++++++++++++++++++
+              0   BB  Aa  +
+                          +
+++++++++++++++++++        +
+                          +
++++++++++++++++++++++++++++