blue: 0,A,E,J,K,L
red: 1,B
yellow: 2,C
magenta: 3,D,G
blue: F
cyan: 5,6,H,I
++++++++++++++++++++++++
+ a G 1            A g +
+ b H 2 +++   ++ 5 B h +
+ c I 3 ++++++++ 6 C i +
+                      + 
+ d J 4          0 D j +
+ e K   ++++++++   E k +
+ f L              F l +
++++++++++++++++++++++++
