red: 0,A
green: 1,B
++++++++++++++++++++++++++++
+             0        Aa  +
+ Bb    1                  +
+ +++++++++++++++++        +
+                      2   +
++++++++++++++++++++++++++++
