red: 0,B,C
blue: 1,2,A
++++++++++++++
+  Aa        +
+  0  C  b   +
+++B         +
+ 1    Cc    +
+++         ++
+ 2     ++a A+
++++++++++++++