red: 0,A
green: 1,B
magenta: 2,C
orange: 3,4,D,F
++++++++++++++++++++++++++++
+             0      A  a  +
+ Bb      1                +
+ +++++++++++++++++   2    +
+ d D   3  c C         4F f+
+        ++++++++++++++++  +
+                          +
++++++++++++++++++++++++++++