red: 0,A
green: 1,B
magenta: 2,C
orange: 3,D
blue: 4,G
++++++++++++++++++++++++++++
+                          +
+                    A  a  +
+ Bb   0  1                +
+ +++++++++++++++++   2    +
+ d D      c C             +
+        ++++++++++++++++  +
+     4  3             gG  +
++++++++++++++++++++++++++++