red: 0,A
blue: 1,B
++++++++++++++++++++++++++++
+0                         +
+          A           a   +
+                          +
+                          +
+                          +
+                          +
+                          +
+          B           b   +
+1                         +
+                          +
++++++++++++++++++++++++++++