+++++++++++++++++++
+0A              +
+AA            ++++
+                 +
+              ++A+
+               +a+
+++++++++++++++++++
