red: 0,B
++++++++++++++++++++++++
+                      +
+0Aa                   +
+++                    +
+1 B                   +
+++        +++  b      +
+       ++aAA+++++++++++
++++++++++++++