++++++++++++++++++++++++
+                      +
+0  Aa                  +
+                      +
+                      +
+                      +
+       ++aAA+++++++++++
++++++++++++++