red: 0,B
blue: 1,A
++++++++++++++
+            +
+0 a     b   +
+++          +
+1 B         +
+++         ++
+       ++aAA+
++++++++++++++
