red: 0,A
green: 1,B 
++++++++++++++++++++++++++++
+                          +
+              1    B    b +
+                          +
+                          +
+                   A    a +
+                          +
+++++++++++++++++++     ++++
+  0                       +
++++++++++++++++++++++++++++