red: 0,1,A,B
+++++++++++++
+ba    A0++++
++++++ ++++++
+    +B+     
+    +1+     
+    +++     