red: 0,A
green: B
++++++++++++++++++++++++++++
+             0        Aa  +
+ Bb    1                  +
+ +++++++++++++++++        +
+                          +
++++++++++++++++++++++++++++
