red: 0,A
green: 1,B 
++++++++++++
+       0+a+
+ ++++++++ +
+          +
+B+A+      +
+b+1+      +
++++++++++++
