red: 0,B
blue: 1,A
cyan:2,C
++++++++++++++
+          Cc+
+0 a     b   +
+++          +
+ 1B         +
+++          +
+2 B   A++ aA+
++++++++++++++