red: 0,A
green: 1,B
magenta: 2,C
orange: 3,4,D,F
blue: 5,G
++++++++++++++++++++++++++++
+             0      A  a  +
+         1                +
+ +++++++++++++++++   2    +
+ d D      c C         4F f+
+        ++++++++++++++++  +
+        3             gG 5+
++++++++++++++++++++++++++++
