red: 0,B,C
blue: 1,2,A
++++++++++++++
+  Aa        +
+  0  C  b   +
+++          +
+ 1B   Cc    +
+++         ++
+ 2     ++a A+
++++++++++++++