red: 0,A
green: 1,B
magenta: 2,C
++++++++++++++++++++++++++++
+                   0  Aa  +
+ Bb 1                     +
+ +++++++++++++++++        +
+          c C 2           +
++++++++++++++++++++++++++++
