red: 0,A
green: 1,B
magenta: 2,C
orange: 3,4,D,F
blue: 5,G
++++++++++++++++++++++++++++
+             0      A  a  +
+ Bb      1                +
+ ++++  +++++++++++   2    +
+ d D      c C           f +
+       4++++++++++++++++  +
+ F      3             gG 5+
++++++++++++++++++++++++++++
