red: 0,A
green: 1,B
magenta: 2,C
orange: 3,D
++++++++++++++++++++++++++++
+            +0+     A  a  +
+ Bb      1  C C           +
+ +++++++++++++++++    2   +
+ d D   3  c C             +
++++++++++++++++++++++++++++
