red: 0,B
blue: 1,A
cyan:2,C
++++++++++++++
+          Cc+
+  a     b   +
+++          +
+ 1B0        +
+++          +
+2 B   A++ aA+
++++++++++++++