red: 0,A
++++++++++++++++++++++++
+            2         +
+0Aa                   +
+++                cC   +
+1 B  b                 +
+++        +++         +
+       ++aAA+++++++++++
++++++++++++++