red: 0,B
blue: 1,A
++++++++++++++
+            +
+0 a    Bb   +
+++          +
+1 B     b   +
+++        +++
+       ++aAA+
++++++++++++++
