red: 0,B
blue: 1,A
++++++++++++++
+  Aa        +
+  0     b   +
+++          +
+     1   B  +
+++         ++
+       ++a A+
++++++++++++++
